{8,8,8,8,8,8,8,8,8,8,8,8,8,8,8,4,4,4,4,4,4,4,4,4,4,4,4,4,4,4,4,8,8,8},
{8,0,0,0,2,2,2,1,1,1,8,3,3,3,3,4,4,4,4,4,4,4,5,5,5,5,4,5,5,5,4,4,8,8},
{8,2,0,0,0,2,2,1,1,1,8,3,2,0,0,4,4,4,4,5,4,5,5,5,5,5,4,5,4,4,4,4,4,8},
{8,2,0,0,0,2,2,1,1,1,8,3,2,0,0,4,4,4,4,5,4,4,4,4,4,4,4,4,4,4,4,4,4,8},
{8,2,2,0,0,2,2,1,1,1,8,3,2,0,0,4,4,4,5,5,4,5,5,5,5,4,4,4,5,4,4,4,4,8},
{8,2,2,0,0,0,2,1,1,1,8,3,2,2,2,4,4,4,4,4,4,5,4,4,4,4,4,4,5,4,5,5,4,8},
{8,2,2,0,0,0,0,1,1,1,1,8,3,3,3,4,4,4,4,5,5,5,4,4,5,4,5,5,5,4,4,5,4,8},
{8,2,2,2,0,0,0,0,1,1,1,8,3,3,3,4,4,4,4,4,4,4,4,4,5,4,4,4,4,4,4,5,4,8},
{8,1,1,1,1,1,8,0,8,1,1,1,8,3,3,3,3,3,3,8,5,5,4,4,5,4,4,5,5,5,4,5,4,8},
{8,1,1,1,1,1,8,0,8,1,1,1,8,3,3,3,3,3,3,3,8,5,4,5,5,5,4,5,4,4,4,5,4,8},
{8,1,1,1,1,1,8,0,8,1,1,1,1,8,3,3,3,3,3,3,3,8,4,5,4,5,4,5,4,4,5,5,5,8},
{8,1,1,1,1,1,8,0,8,1,1,1,1,1,8,3,3,3,3,3,3,8,4,4,4,5,5,5,4,4,4,5,4,8},
{8,1,1,1,1,1,8,0,8,1,1,1,1,1,8,8,8,8,8,8,3,8,8,8,4,4,4,5,4,5,4,5,4,8},
{1,1,1,1,0,0,0,0,0,0,1,1,1,1,1,1,1,3,3,3,3,8,8,8,4,4,4,5,4,5,4,5,4,8},
{1,1,0,0,0,0,0,0,0,0,0,2,2,2,2,1,1,3,3,3,3,8,2,2,4,4,4,5,4,5,4,4,4,7},
{1,1,0,0,0,8,8,8,8,0,0,2,2,2,2,1,1,3,3,3,3,8,2,2,4,4,4,4,4,5,4,4,4,7},
{1,1,0,0,0,4,4,4,4,4,0,0,2,2,2,2,2,3,3,3,3,8,2,2,7,7,7,7,7,7,7,7,7,7},
{1,1,1,1,1,4,4,4,4,4,4,0,0,2,2,2,2,3,3,3,3,8,2,2,7,6,7,7,7,6,6,6,6,6},
{1,1,1,1,1,2,2,2,4,3,3,3,0,0,0,0,0,0,3,3,3,8,2,2,7,6,6,6,7,6,6,6,6,6},
{1,1,1,1,1,2,2,2,4,3,3,3,8,0,0,1,1,1,3,3,7,7,2,7,7,6,7,6,7,6,6,6,6,6},
{1,1,1,1,7,7,7,2,7,8,3,3,4,0,1,1,1,1,3,3,7,2,2,6,6,6,7,6,7,6,6,6,6,6},
{1,1,1,1,7,3,3,3,3,3,3,3,4,0,1,1,1,1,3,3,7,2,7,6,7,6,7,6,6,6,6,6,6,6},
{1,7,7,7,7,3,3,3,3,3,3,3,4,0,1,1,1,1,1,1,7,2,7,6,7,6,7,6,6,6,6,6,6,6},
{1,7,7,7,7,3,3,3,3,3,3,8,4,0,1,1,7,7,7,7,7,2,7,6,7,6,7,6,7,6,6,6,6,6},
{1,7,2,2,2,3,3,3,3,3,3,3,4,0,1,1,7,6,6,6,6,6,7,6,7,6,7,6,7,6,6,6,6,6},
{1,7,2,2,2,3,3,8,3,3,3,0,0,0,1,1,7,6,6,6,6,6,7,6,7,6,7,6,7,6,6,6,6,6},
{1,7,2,2,2,3,3,3,3,3,3,0,0,0,1,1,7,6,7,6,7,7,7,6,6,6,7,7,7,6,6,6,6,6},
{1,7,7,7,7,7,7,7,7,7,8,8,8,8,1,1,7,6,7,6,6,6,7,6,7,6,6,6,7,6,6,6,6,6},
{1,7,7,7,2,2,2,2,2,3,4,4,8,6,6,6,7,6,7,6,6,6,7,6,7,7,7,6,7,6,6,6,6,6},
{1,2,2,2,2,2,2,2,2,3,4,4,8,6,6,6,6,6,7,7,7,6,7,6,7,6,7,6,7,6,6,6,6,6},
{1,1,1,1,1,1,1,1,1,3,4,4,8,6,6,6,6,6,6,6,7,6,7,6,6,6,7,6,6,6,6,6,6,6},
{1,1,1,1,1,1,1,1,1,3,3,3,8,6,6,6,6,6,6,6,7,6,7,7,7,7,7,7,7,6,6,6,6,6},
{1,1,1,1,1,1,1,1,1,1,1,3,8,6,6,6,6,6,6,6,6,6,6,6,6,6,6,6,6,6,6,6,6,6},
{1,1,1,1,1,1,1,1,1,1,1,3,8,6,6,6,6,6,6,6,6,6,6,6,6,6,6,6,6,6,6,6,6,6},
{1,1,1,1,1,1,1,1,1,1,1,1,8,6,6,6,6,6,6,6,6,6,6,6,6,6,6,6,6,6,6,6,6,6},
{1,1,1,1,1,1,2,2,2,2,2,1,8,6,6,6,6,6,6,6,6,6,6,6,6,6,6,6,6,6,6,6,6,6},
{4,4,4,4,4,1,2,2,2,2,2,1,8,6,6,6,6,6,6,6,6,6,6,6,6,6,6,6,6,6,6,6,6,6},
{4,4,4,4,4,1,2,2,2,2,2,1,8,6,6,6,6,6,6,6,6,6,6,6,6,6,6,6,6,6,6,6,6,6},
{4,4,4,4,4,1,2,2,2,2,2,1,8,6,6,6,6,6,6,6,6,6,6,6,6,6,6,6,6,6,6,6,6,6},
{4,4,4,4,4,1,1,1,1,1,1,1,8,6,6,6,6,6,6,6,6,6,6,6,6,6,6,6,6,6,6,6,6,6},
{4,4,4,4,4,8,8,8,8,8,8,8,8,6,6,6,6,6,6,6,6,6,6,6,6,6,6,6,6,6,6,6,6,6},
{8,8,8,8,8,8,8,8,8,8,8,8,8,6,6,6,6,6,6,6,6,6,6,6,6,6,6,6,6,6,6,6,6,6}